sentiment:Hola.\r\nHace	yes
sentiment:me	no
sentiment:No	no
sentiment:Hola,	no
sentiment:He	no
sentiment:Buenas	yes
sentiment:De	yes
sentiment:Este	no
sentiment:JAMAS	no
sentiment:He	no
sentiment:Tenemos	yes
sentiment:La	yes
sentiment:Ante	no
sentiment:Lo	no
sentiment:Siguiendo	yes
sentiment:Acer	no
sentiment:Sampedro	yes
sentiment:Bueno	no
sentiment:Hace	yes
sentiment:==	yes
sentiment:Es	no
sentiment:Hola	yes
sentiment:Por	no
sentiment:Fue	yes
sentiment:Yo	no
sentiment:El	no
sentiment:El	no
sentiment:Si	no
sentiment:Mark	yes
sentiment:Los	no
